"row","Total: All usual residents aged 16 years and over","Economically active (excluding full-time students)","Economically active (excluding full-time students):In employment","Economically active (excluding full-time students):In employment:Employee","Economically active (excluding full-time students): In employment: Employee: Part-time","Economically active (excluding full-time students): In employment: Employee: Full-time","Economically active (excluding full-time students):In employment:Self-employed with employees","Economically active (excluding full-time students): In employment: Self-employed with employees: Part-time","Economically active (excluding full-time students): In employment: Self-employed with employees: Full-time","Economically active (excluding full-time students):In employment:Self-employed without employees","Economically active (excluding full-time students): In employment: Self-employed without employees: Part-time","Economically active (excluding full-time students): In employment: Self-employed without employees: Full-time","Economically active (excluding full-time students): Unemployed","Economically active and a full-time student","Economically active and a full-time student:In employment","Economically active and a full-time student:In employment:Employee","Economically active and a full-time student: In employment: Employee: Part-time","Economically active and a full-time student: In employment: Employee: Full-time","Economically active and a full-time student:In employment:Self-employed with employees","Economically active and a full-time student: In employment: Self-employed with employees: Part-time","Economically active and a full-time student: In employment: Self-employed with employees: Full-time","Economically active and a full-time student:In employment:Self-employed without employees","Economically active and a full-time student: In employment: Self-employed without employees: Part-time","Economically active and a full-time student: In employment: Self-employed without employees: Full-time","Economically active and a full-time student: Unemployed","Economically inactive","Economically inactive: Retired","Economically inactive: Student","Economically inactive: Looking after home or family","Economically inactive: Long-term sick or disabled","Economically inactive: Other","2021 super output area - lower layer","mnemonic"
1,1212,706,676,579,163,416,19,7,12,78,44,34,30,23,19,18,16,2,0,0,0,1,0,1,4,483,373,45,23,19,23,"Leeds 001A","E01011698"
2,1100,595,586,495,128,367,15,3,12,76,34,42,9,18,14,14,13,1,0,0,0,0,0,0,4,487,414,29,15,12,17,"Leeds 001B","E01011699"
3,1144,628,609,514,139,375,10,4,6,85,42,43,19,18,14,14,13,1,0,0,0,0,0,0,4,498,391,44,22,23,18,"Leeds 001C","E01011701"
4,1323,720,697,572,139,433,44,5,39,81,45,36,23,20,18,17,16,1,0,0,0,1,1,0,2,583,446,58,45,16,18,"Leeds 001D","E01011702"
5,1101,415,397,345,106,239,6,2,4,46,26,20,18,13,8,8,6,2,0,0,0,0,0,0,5,673,571,34,33,11,24,"Leeds 001E","E01011703"
6,2005,850,811,668,180,488,42,16,26,101,43,58,39,32,25,24,19,5,0,0,0,1,0,1,7,1123,392,69,44,117,501,"Leeds 002A","E01011697"
7,1289,575,562,483,122,361,13,2,11,66,23,43,13,11,9,9,8,1,0,0,0,0,0,0,2,703,486,41,24,63,89,"Leeds 002B","E01011700"
8,1933,964,935,795,170,625,36,7,29,104,47,57,29,20,12,10,9,1,0,0,0,2,1,1,8,949,705,33,50,111,50,"Leeds 002C","E01011704"
9,1138,647,615,539,133,406,10,3,7,66,31,35,32,12,9,7,7,0,0,0,0,2,2,0,3,479,319,29,38,65,28,"Leeds 002D","E01011705"
10,1359,766,735,614,172,442,19,1,18,102,42,60,31,16,6,4,3,1,0,0,0,2,0,2,10,577,451,44,33,24,25,"Leeds 003A","E01011581"
11,1293,735,688,555,194,361,17,2,15,116,42,74,47,25,20,19,16,3,0,0,0,1,1,0,5,533,305,35,55,98,40,"Leeds 003B","E01011582"
12,1268,769,746,608,179,429,24,7,17,114,53,61,23,16,9,7,6,1,0,0,0,2,2,0,7,483,357,43,40,19,24,"Leeds 003C","E01011583"
13,1377,796,779,647,173,474,11,2,9,121,58,63,17,25,18,17,16,1,0,0,0,1,1,0,7,556,436,44,35,32,9,"Leeds 003D","E01011584"
14,1483,858,828,676,173,503,27,11,16,125,62,63,30,23,18,17,11,6,0,0,0,1,1,0,5,602,456,39,43,40,24,"Leeds 004A","E01011569"
15,1371,782,762,610,170,440,17,1,16,135,68,67,20,23,21,21,21,0,0,0,0,0,0,0,2,566,409,40,44,51,22,"Leeds 004B","E01011571"
16,1471,927,900,775,219,556,12,4,8,113,45,68,27,26,21,21,18,3,0,0,0,0,0,0,5,518,379,50,42,34,13,"Leeds 004C","E01011572"
17,1056,633,617,524,153,371,14,2,12,79,34,45,16,18,17,17,16,1,0,0,0,0,0,0,1,405,302,35,29,22,17,"Leeds 004D","E01011573"
18,1222,587,570,472,124,348,9,0,9,89,44,45,17,16,10,10,6,4,0,0,0,0,0,0,6,619,483,28,33,57,18,"Leeds 004E","E01011574"
19,1092,555,547,452,134,318,16,5,11,79,27,52,8,29,21,20,20,0,0,0,0,1,1,0,8,508,402,42,24,25,15,"Leeds 005A","E01011707"
20,1612,862,840,684,158,526,36,5,31,120,58,62,22,27,22,22,20,2,0,0,0,0,0,0,5,723,553,70,51,34,15,"Leeds 005B","E01011709"
21,1136,681,669,543,148,395,28,7,21,98,49,49,12,14,12,12,12,0,0,0,0,0,0,0,2,441,349,30,29,22,11,"Leeds 005C","E01011710"
22,1197,651,631,488,116,372,36,13,23,107,51,56,20,20,12,12,9,3,0,0,0,0,0,0,8,526,403,38,35,27,23,"Leeds 005D","E01011711"
23,1179,718,702,563,150,413,16,4,12,123,51,72,16,19,12,12,11,1,0,0,0,0,0,0,7,442,313,39,48,19,23,"Leeds 005E","E01011712"
24,1004,622,599,465,102,363,38,5,33,96,46,50,23,4,4,3,3,0,0,0,0,1,1,0,0,378,270,36,37,9,26,"Leeds 006A","E01011561"
25,1278,701,683,535,166,369,33,6,27,115,56,59,18,11,10,10,7,3,0,0,0,0,0,0,1,566,455,44,33,18,16,"Leeds 006B","E01011696"
26,1248,658,648,493,129,364,53,12,41,102,59,43,10,18,15,15,10,5,0,0,0,0,0,0,3,572,432,59,52,7,22,"Leeds 006C","E01011706"
27,1212,711,689,520,138,382,42,9,33,127,68,59,22,15,11,11,11,0,0,0,0,0,0,0,4,486,376,34,34,20,22,"Leeds 006D","E01011708"
28,1423,831,821,609,168,441,69,18,51,143,73,70,10,18,14,14,11,3,0,0,0,0,0,0,4,574,453,47,43,8,23,"Leeds 006E","E01011713"
29,1855,1113,1085,858,231,627,48,7,41,179,89,90,28,34,28,28,25,3,0,0,0,0,0,0,6,708,507,81,60,35,25,"Leeds 007A","E01011570"
30,1193,711,691,525,133,392,63,8,55,103,51,52,20,16,12,12,11,1,0,0,0,0,0,0,4,466,329,49,47,19,22,"Leeds 007C","E01011576"
31,1195,678,664,499,137,362,37,6,31,128,62,66,14,21,16,16,13,3,0,0,0,0,0,0,5,496,376,43,44,10,23,"Leeds 007E","E01032503"
32,1443,767,743,567,172,395,44,7,37,132,62,70,24,22,10,9,7,2,0,0,0,1,1,0,12,654,504,61,52,19,18,"Leeds 007F","E01032504"
33,2108,1437,1416,1191,263,928,71,9,62,154,56,98,21,27,23,19,14,5,1,0,1,3,3,0,4,644,472,68,51,21,32,"Leeds 008A","E01011266"
34,1404,778,768,611,166,445,36,5,31,121,57,64,10,23,16,16,13,3,0,0,0,0,0,0,7,603,490,48,39,12,14,"Leeds 008B","E01011270"
35,1088,632,619,519,136,383,19,4,15,81,32,49,13,19,12,11,8,3,1,1,0,0,0,0,7,437,350,38,21,19,9,"Leeds 008C","E01011279"
36,1653,1084,1061,892,210,682,28,3,25,141,59,82,23,25,23,20,19,1,0,0,0,3,3,0,2,544,393,69,35,14,33,"Leeds 008D","E01011280"
37,1598,972,943,818,160,658,20,4,16,105,44,61,29,18,12,12,9,3,0,0,0,0,0,0,6,608,414,66,47,60,21,"Leeds 009A","E01011265"
38,1364,778,749,632,162,470,14,2,12,103,45,58,29,20,15,15,13,2,0,0,0,0,0,0,5,566,357,68,42,66,33,"Leeds 009B","E01011267"
39,1710,1075,1042,895,204,691,23,11,12,124,62,62,33,40,31,31,26,5,0,0,0,0,0,0,9,595,452,51,40,20,32,"Leeds 009C","E01011271"
40,1174,722,695,616,169,447,14,1,13,65,28,37,27,24,16,15,12,3,0,0,0,1,0,1,8,428,328,49,21,9,21,"Leeds 009D","E01011272"
41,1100,662,623,552,162,390,11,1,10,60,25,35,39,17,15,15,14,1,0,0,0,0,0,0,2,421,204,40,57,79,41,"Leeds 010A","E01011268"
42,1245,803,776,669,147,522,11,4,7,96,56,40,27,24,21,21,18,3,0,0,0,0,0,0,3,418,293,33,32,35,25,"Leeds 010B","E01011273"
43,1104,623,573,502,140,362,6,1,5,65,26,39,50,32,15,14,12,2,1,0,1,0,0,0,17,449,286,33,36,71,23,"Leeds 010C","E01011274"
44,1118,660,639,545,157,388,14,6,8,80,24,56,21,20,16,15,12,3,0,0,0,1,1,0,4,438,292,39,35,46,26,"Leeds 010D","E01011275"
45,1105,596,574,487,136,351,7,2,5,80,42,38,22,15,7,7,6,1,0,0,0,0,0,0,8,494,367,32,24,41,30,"Leeds 011A","E01011264"
46,1327,775,752,643,172,471,20,5,15,89,38,51,23,19,17,17,14,3,0,0,0,0,0,0,2,533,373,39,24,56,41,"Leeds 011B","E01011269"
47,1443,935,909,772,179,593,26,7,19,111,54,57,26,15,12,12,9,3,0,0,0,0,0,0,3,493,386,35,23,19,30,"Leeds 011C","E01011276"
48,1086,602,586,504,140,364,16,2,14,66,31,35,16,20,14,14,14,0,0,0,0,0,0,0,6,464,359,28,33,32,12,"Leeds 011D","E01011578"
49,1139,663,645,527,130,397,26,4,22,92,46,46,18,20,18,18,13,5,0,0,0,0,0,0,2,456,330,53,35,18,20,"Leeds 012A","E01011554"
50,1303,725,700,510,136,374,59,12,47,131,73,58,25,11,7,7,6,1,0,0,0,0,0,0,4,567,413,57,58,13,26,"Leeds 012B","E01011562"
51,1161,626,608,478,116,362,42,10,32,88,48,40,18,14,11,10,6,4,0,0,0,1,1,0,3,521,411,34,32,14,30,"Leeds 012C","E01011563"
52,1228,747,727,598,144,454,25,4,21,104,53,51,20,32,18,16,12,4,0,0,0,2,2,0,14,449,335,49,42,8,15,"Leeds 012D","E01011564"
53,1146,709,691,577,147,430,19,6,13,95,40,55,18,25,19,16,16,0,0,0,0,3,3,0,6,412,288,49,54,11,10,"Leeds 012E","E01011567"
54,1348,827,811,707,186,521,19,3,16,85,33,52,16,27,20,20,16,4,0,0,0,0,0,0,7,494,419,23,33,17,2,"Leeds 013A","E01011376"
55,1163,626,616,525,138,387,20,1,19,71,30,41,10,17,10,10,9,1,0,0,0,0,0,0,7,520,407,45,29,23,16,"Leeds 013B","E01011377"
56,1145,582,525,461,126,335,14,5,9,50,23,27,57,18,12,12,9,3,0,0,0,0,0,0,6,545,223,59,69,135,59,"Leeds 013C","E01011378"
57,1326,821,801,697,166,531,15,1,14,89,32,57,20,10,6,6,3,3,0,0,0,0,0,0,4,495,393,41,32,13,16,"Leeds 013D","E01011382"
58,1272,896,867,765,171,594,13,0,13,89,32,57,29,26,20,20,20,0,0,0,0,0,0,0,6,350,215,55,34,25,21,"Leeds 014A","E01011277"
59,1358,892,873,752,184,568,20,5,15,101,42,59,19,30,24,21,17,4,1,1,0,2,1,1,6,436,333,39,20,30,14,"Leeds 014B","E01011278"
60,1030,704,676,567,143,424,20,2,18,89,40,49,28,14,12,12,11,1,0,0,0,0,0,0,2,312,222,29,29,24,8,"Leeds 014C","E01011579"
61,1148,661,641,526,130,396,33,9,24,82,39,43,20,23,18,18,17,1,0,0,0,0,0,0,5,464,360,44,25,24,11,"Leeds 014D","E01011580"
62,1357,861,812,689,161,528,17,6,11,106,46,60,49,32,18,16,14,2,0,0,0,2,2,0,14,464,249,73,58,43,41,"Leeds 015A","E01011556"
63,1162,668,654,524,128,396,33,10,23,97,44,53,14,23,18,16,14,2,0,0,0,2,2,0,5,471,334,33,48,34,22,"Leeds 015B","E01011557"
64,1161,714,694,571,160,411,27,8,19,96,46,50,20,22,16,16,14,2,0,0,0,0,0,0,6,425,299,36,48,22,20,"Leeds 015C","E01011565"
65,1077,651,619,503,116,387,18,6,12,98,46,52,32,8,5,4,4,0,0,0,0,1,1,0,3,418,265,56,44,31,22,"Leeds 015D","E01011566"
66,1579,899,867,688,175,513,33,9,24,146,62,84,32,11,10,10,8,2,0,0,0,0,0,0,1,669,517,41,42,35,34,"Leeds 015E","E01011568"
67,1291,715,691,564,144,420,42,8,34,85,39,46,24,18,14,14,12,2,0,0,0,0,0,0,4,558,437,48,30,23,20,"Leeds 016A","E01011380"
68,1235,667,661,548,136,412,23,6,17,90,45,45,6,14,14,14,13,1,0,0,0,0,0,0,0,554,343,54,49,15,93,"Leeds 016B","E01011381"
69,1120,606,552,448,111,337,24,4,20,80,41,39,54,16,11,10,7,3,0,0,0,1,1,0,5,498,333,67,41,32,25,"Leeds 016C","E01011385"
70,1449,931,905,723,145,578,56,17,39,126,57,69,26,27,21,21,17,4,0,0,0,0,0,0,6,491,307,79,54,15,36,"Leeds 016D","E01011386"
71,1257,707,661,549,167,382,16,3,13,96,43,53,46,20,18,15,9,6,1,0,1,2,2,0,2,530,258,56,66,109,41,"Leeds 017A","E01011379"
72,1218,705,682,576,155,421,17,4,13,89,42,47,23,13,8,8,6,2,0,0,0,0,0,0,5,500,321,51,44,61,23,"Leeds 017B","E01011384"
73,975,609,596,506,132,374,6,1,5,84,35,49,13,7,4,3,3,0,0,0,0,1,0,1,3,359,260,42,26,17,14,"Leeds 017E","E01032501"
74,1463,917,865,736,204,532,20,8,12,109,42,67,52,36,29,26,19,7,0,0,0,3,3,0,7,510,180,70,97,118,45,"Leeds 017F","E01032502"
75,1106,642,623,510,129,381,22,7,15,91,43,48,19,11,8,7,5,2,0,0,0,1,1,0,3,453,331,43,35,24,20,"Leeds 018A","E01011555"
76,1256,712,652,547,179,368,21,7,14,84,47,37,60,24,15,14,11,3,1,0,1,0,0,0,9,520,163,73,125,96,63,"Leeds 018B","E01011558"
77,1099,581,536,436,143,293,18,4,14,82,41,41,45,34,25,25,21,4,0,0,0,0,0,0,9,484,181,69,72,117,45,"Leeds 018C","E01011559"
78,1424,756,698,578,225,353,17,9,8,103,53,50,58,20,17,15,11,4,1,0,1,1,1,0,3,648,241,81,113,132,81,"Leeds 018D","E01011560"
79,1367,770,753,632,169,463,28,10,18,93,40,53,17,16,12,11,9,2,0,0,0,1,1,0,4,581,372,77,64,41,27,"Leeds 019A","E01011383"
80,1326,755,729,614,136,478,22,5,17,93,42,51,26,19,16,14,10,4,0,0,0,2,2,0,3,552,346,69,48,48,41,"Leeds 019B","E01011388"
81,1253,754,730,613,161,452,16,3,13,101,46,55,24,26,23,22,18,4,0,0,0,1,1,0,3,473,320,57,51,24,21,"Leeds 019C","E01011684"
82,1320,692,631,553,174,379,13,3,10,65,28,37,61,45,24,20,16,4,1,0,1,3,1,2,21,583,223,91,76,115,78,"Leeds 019D","E01011695"
83,1180,736,710,563,138,425,31,8,23,116,65,51,26,14,11,11,8,3,0,0,0,0,0,0,3,430,297,49,45,16,23,"Leeds 020A","E01011650"
84,1165,761,730,629,137,492,17,4,13,84,30,54,31,30,27,22,18,4,1,1,0,4,4,0,3,374,203,49,50,42,30,"Leeds 020B","E01011651"
85,1157,773,749,626,109,517,28,7,21,95,39,56,24,23,19,13,11,2,1,1,0,5,5,0,4,361,229,56,25,19,32,"Leeds 020C","E01011653"
86,1231,720,702,541,118,423,49,11,38,112,52,60,18,12,5,5,5,0,0,0,0,0,0,0,7,499,361,47,37,35,19,"Leeds 020D","E01011655"
87,1101,567,561,468,108,360,22,2,20,71,38,33,6,50,24,22,19,3,0,0,0,2,2,0,26,484,297,153,21,7,6,"Leeds 021A","E01011455"
88,1691,765,743,615,145,470,34,7,27,94,38,56,22,144,83,80,72,8,0,0,0,3,2,1,61,782,421,301,29,13,18,"Leeds 021B","E01011456"
89,1408,868,842,708,143,565,34,17,17,100,49,51,26,24,15,12,12,0,0,0,0,3,2,1,9,516,316,60,32,56,52,"Leeds 021C","E01011459"
90,1223,693,675,566,152,414,29,3,26,80,42,38,18,18,13,13,12,1,0,0,0,0,0,0,5,512,410,42,34,14,12,"Leeds 021D","E01011461"
91,1007,602,592,444,116,328,50,7,43,98,49,49,10,7,5,5,3,2,0,0,0,0,0,0,2,398,263,43,56,15,21,"Leeds 022A","E01011311"
92,1266,739,709,550,140,410,27,5,22,132,73,59,30,13,8,8,7,1,0,0,0,0,0,0,5,514,402,41,40,10,21,"Leeds 022B","E01011649"
93,1144,696,675,558,120,438,21,1,20,96,40,56,21,21,19,18,16,2,0,0,0,1,0,1,2,427,339,32,24,21,11,"Leeds 022C","E01011715"
94,1222,632,620,522,131,391,18,3,15,80,30,50,12,23,12,12,12,0,0,0,0,0,0,0,11,567,447,36,26,46,12,"Leeds 022D","E01011719"
95,1179,647,623,528,134,394,17,3,14,78,35,43,24,12,12,11,8,3,0,0,0,1,1,0,0,520,399,25,32,28,36,"Leeds 023A","E01011509"
96,1135,686,664,551,153,398,26,4,22,87,45,42,22,28,20,20,18,2,0,0,0,0,0,0,8,421,236,63,56,31,35,"Leeds 023B","E01011511"
97,1371,877,858,723,169,554,23,4,19,112,55,57,19,29,22,18,16,2,0,0,0,4,3,1,7,465,277,60,62,40,26,"Leeds 023C","E01011512"
98,1231,811,777,654,145,509,25,5,20,98,38,60,34,20,19,15,10,5,2,0,2,2,2,0,1,400,275,52,32,23,18,"Leeds 023D","E01011515"
99,1408,941,914,789,189,600,23,4,19,102,52,50,27,16,11,9,7,2,0,0,0,2,2,0,5,451,271,67,33,27,53,"Leeds 023E","E01011516"
100,1106,722,702,586,153,433,19,2,17,97,48,49,20,20,20,20,18,2,0,0,0,0,0,0,0,364,207,61,41,23,32,"Leeds 024A","E01011508"
101,1369,896,848,728,156,572,17,5,12,103,47,56,48,27,22,21,20,1,1,0,1,0,0,0,5,446,228,60,53,60,45,"Leeds 024B","E01011517"
102,1147,736,724,611,141,470,23,4,19,90,45,45,12,23,17,17,13,4,0,0,0,0,0,0,6,388,255,40,31,35,27,"Leeds 024C","E01011652"
103,1121,725,710,597,164,433,24,6,18,89,50,39,15,22,16,15,15,0,1,1,0,0,0,0,6,374,251,56,42,9,16,"Leeds 024D","E01011654"
104,1336,769,745,639,165,474,18,5,13,88,33,55,24,24,19,19,16,3,0,0,0,0,0,0,5,543,332,48,63,61,39,"Leeds 025A","E01011505"
105,1193,739,709,594,139,455,19,7,12,96,38,58,30,21,17,16,12,4,0,0,0,1,1,0,4,433,211,67,68,47,40,"Leeds 025B","E01011506"
106,1309,894,872,720,152,568,31,8,23,121,67,54,22,16,12,11,8,3,0,0,0,1,1,0,4,399,268,55,34,26,16,"Leeds 025C","E01011507"
107,1267,581,503,421,126,295,8,1,7,74,36,38,78,22,7,7,6,1,0,0,0,0,0,0,15,664,344,67,78,127,48,"Leeds 025D","E01011510"
108,1393,920,891,726,172,554,27,4,23,138,69,69,29,27,20,19,15,4,0,0,0,1,1,0,7,446,242,74,62,28,40,"Leeds 025E","E01011514"
109,1302,834,821,702,163,539,27,2,25,92,45,47,13,26,21,20,18,2,0,0,0,1,1,0,5,442,323,55,30,16,18,"Leeds 027A","E01011452"
110,1267,921,891,775,156,619,14,2,12,102,46,56,30,20,16,15,9,6,0,0,0,1,0,1,4,326,247,45,13,7,14,"Leeds 027B","E01011454"
111,1296,787,778,627,133,494,54,5,49,97,41,56,9,17,14,13,11,2,0,0,0,1,1,0,3,492,341,73,39,13,26,"Leeds 027C","E01011457"
112,2008,1415,1389,1171,265,906,59,10,49,159,61,98,26,28,23,22,20,2,0,0,0,1,0,1,5,565,374,93,58,17,23,"Leeds 027D","E01011458"
113,1393,897,863,763,169,594,11,2,9,89,33,56,34,23,19,18,12,6,0,0,0,1,0,1,4,473,313,37,51,46,26,"Leeds 027E","E01011465"
114,1301,797,778,674,157,517,17,3,14,87,54,33,19,15,12,11,10,1,0,0,0,1,0,1,3,489,391,40,17,14,27,"Leeds 028A","E01011453"
115,1190,779,748,661,139,522,13,3,10,74,34,40,31,18,8,7,6,1,1,0,1,0,0,0,10,393,224,51,53,37,28,"Leeds 028B","E01011460"
116,1355,813,786,680,170,510,17,3,14,89,40,49,27,28,27,23,19,4,0,0,0,4,3,1,1,514,277,64,56,70,47,"Leeds 028C","E01011462"
117,1341,762,712,590,174,416,13,4,9,109,50,59,50,23,16,16,12,4,0,0,0,0,0,0,7,556,298,70,57,91,40,"Leeds 028D","E01011463"
118,1526,1123,1092,959,150,809,18,1,17,115,54,61,31,39,29,24,19,5,0,0,0,5,4,1,10,364,225,50,36,30,23,"Leeds 028E","E01011464"
119,1510,950,918,791,183,608,26,5,21,101,41,60,32,24,19,19,15,4,0,0,0,0,0,0,5,536,387,48,44,34,23,"Leeds 029A","E01011714"
120,1265,755,730,569,122,447,32,13,19,129,51,78,25,18,12,11,10,1,0,0,0,1,1,0,6,492,326,53,43,35,35,"Leeds 029B","E01011716"
121,1303,773,740,640,171,469,17,6,11,83,33,50,33,15,14,13,8,5,0,0,0,1,0,1,1,515,315,41,63,68,28,"Leeds 029C","E01011717"
122,1520,1007,955,858,198,660,16,3,13,81,24,57,52,31,19,17,11,6,0,0,0,2,2,0,12,482,217,43,74,113,35,"Leeds 029D","E01011718"
123,1213,681,639,581,167,414,5,1,4,53,16,37,42,19,10,10,8,2,0,0,0,0,0,0,9,513,270,34,56,115,38,"Leeds 029E","E01011720"
124,1403,685,662,542,140,402,19,1,18,101,43,58,23,15,12,11,7,4,0,0,0,1,1,0,3,703,596,26,35,20,26,"Leeds 030A","E01011296"
125,1398,902,875,736,162,574,30,6,24,109,44,65,27,21,12,11,10,1,0,0,0,1,0,1,9,475,331,54,35,32,23,"Leeds 030B","E01011297"
126,1251,745,713,556,146,410,31,12,19,126,48,78,32,14,11,9,9,0,0,0,0,2,2,0,3,492,365,33,40,29,25,"Leeds 030C","E01011309"
127,1336,758,736,580,143,437,43,10,33,113,57,56,22,20,16,16,16,0,0,0,0,0,0,0,4,558,430,46,27,24,31,"Leeds 030D","E01011310"
128,1782,1246,1213,1031,214,817,38,7,31,144,71,73,33,25,21,19,14,5,0,0,0,2,1,1,4,511,301,83,48,41,38,"Leeds 031A","E01011513"
129,1191,826,792,707,141,566,13,2,11,72,29,43,34,27,14,10,8,2,0,0,0,4,3,1,13,338,162,52,46,39,39,"Leeds 031B","E01011688"
130,1370,899,879,765,167,598,20,3,17,94,44,50,20,15,13,12,7,5,0,0,0,1,1,0,2,456,315,43,16,48,34,"Leeds 031C","E01011689"
131,1273,752,711,639,162,477,9,3,6,63,32,31,41,51,42,36,31,5,0,0,0,6,6,0,9,470,193,76,54,106,41,"Leeds 031D","E01011691"
132,1214,715,648,553,147,406,6,4,2,89,41,48,67,21,10,9,3,6,0,0,0,1,1,0,11,478,166,51,74,116,71,"Leeds 032A","E01011504"
133,1247,824,792,659,143,516,25,2,23,108,47,61,32,21,18,17,17,0,0,0,0,1,1,0,3,402,259,73,24,24,22,"Leeds 032B","E01011641"
134,1044,678,650,539,136,403,16,6,10,95,50,45,28,23,20,18,15,3,0,0,0,2,0,2,3,343,178,61,59,23,22,"Leeds 032C","E01011642"
135,1202,801,774,636,155,481,31,6,25,107,55,52,27,12,7,6,5,1,0,0,0,1,1,0,5,389,217,81,42,26,23,"Leeds 032D","E01011645"
136,1217,661,596,503,155,348,9,3,6,84,38,46,65,21,16,16,10,6,0,0,0,0,0,0,5,535,164,83,95,120,73,"Leeds 033A","E01011484"
137,1285,744,680,591,155,436,12,3,9,77,37,40,64,16,13,13,9,4,0,0,0,0,0,0,3,525,213,68,76,87,81,"Leeds 033B","E01011485"
138,1257,668,619,530,137,393,18,6,12,71,35,36,49,17,13,13,10,3,0,0,0,0,0,0,4,572,220,58,88,136,70,"Leeds 033E","E01011686"
139,1184,805,786,697,128,569,8,0,8,81,35,46,19,7,3,3,1,2,0,0,0,0,0,0,4,372,262,35,31,16,28,"Leeds 033F","E01032493"
140,1478,887,829,725,219,506,22,5,17,82,41,41,58,30,19,16,11,5,0,0,0,3,3,0,11,561,158,97,92,105,109,"Leeds 033G","E01032494"
141,1326,857,836,723,143,580,21,4,17,92,39,53,21,24,24,22,19,3,0,0,0,2,1,1,0,445,283,98,30,15,19,"Leeds 034A","E01011350"
142,1530,1066,1039,907,150,757,28,6,22,104,43,61,27,25,20,19,13,6,0,0,0,1,1,0,5,439,283,55,25,52,24,"Leeds 034B","E01011351"
143,1673,1222,1166,1033,142,891,15,2,13,118,49,69,56,25,22,21,15,6,0,0,0,1,1,0,3,426,248,55,29,55,39,"Leeds 034C","E01011352"
144,1625,1167,1136,977,187,790,21,2,19,138,73,65,31,27,22,19,16,3,1,0,1,2,2,0,5,431,286,60,23,26,36,"Leeds 034D","E01011353"
145,1126,694,637,554,163,391,12,1,11,71,25,46,57,10,6,6,6,0,0,0,0,0,0,0,4,422,120,55,78,123,46,"Leeds 035A","E01011656"
146,1017,543,489,427,140,287,7,1,6,55,28,27,54,17,9,8,5,3,0,0,0,1,0,1,8,457,200,48,59,108,42,"Leeds 035B","E01011657"
147,1131,614,567,514,136,378,3,1,2,50,24,26,47,21,17,15,10,5,1,0,1,1,0,1,4,496,192,62,61,141,40,"Leeds 035C","E01011659"
148,1440,617,543,474,142,332,9,3,6,60,22,38,74,16,13,12,10,2,0,0,0,1,1,0,3,807,441,34,82,182,68,"Leeds 035D","E01011661"
149,1241,665,645,523,109,414,35,9,26,87,41,46,20,15,14,10,8,2,0,0,0,4,4,0,1,561,400,57,41,45,18,"Leeds 037A","E01011643"
150,1046,601,576,465,122,343,22,6,16,89,43,46,25,25,20,17,14,3,0,0,0,3,2,1,5,420,271,44,47,35,23,"Leeds 037B","E01011644"
151,1443,874,836,696,185,511,21,6,15,119,51,68,38,33,18,18,13,5,0,0,0,0,0,0,15,536,258,102,99,36,41,"Leeds 037C","E01011646"
152,1423,772,727,562,191,371,29,12,17,136,63,73,45,42,25,23,14,9,0,0,0,2,1,1,17,609,207,126,151,53,72,"Leeds 037D","E01011647"
153,1464,838,790,627,184,443,30,11,19,133,61,72,48,49,34,32,30,2,0,0,0,2,1,1,15,577,232,117,109,33,86,"Leeds 037E","E01011648"
154,1138,665,594,526,181,345,16,11,5,52,24,28,71,33,23,21,15,6,0,0,0,2,2,0,10,440,125,82,85,103,45,"Leeds 038A","E01011354"
155,1177,735,687,594,152,442,14,6,8,79,21,58,48,28,21,19,16,3,0,0,0,2,2,0,7,414,166,76,47,83,42,"Leeds 038B","E01011355"
156,1585,887,794,641,214,427,21,10,11,132,69,63,93,48,41,38,34,4,0,0,0,3,2,1,7,650,188,118,121,142,81,"Leeds 038C","E01011357"
157,1064,611,584,504,115,389,7,2,5,73,34,39,27,14,14,11,8,3,0,0,0,3,1,2,0,439,193,65,57,83,41,"Leeds 038D","E01011450"
158,1384,951,928,781,176,605,36,12,24,111,46,65,23,29,25,22,19,3,1,1,0,2,2,0,4,404,273,46,38,32,15,"Leeds 039A","E01011588"
159,1267,878,869,743,154,589,31,8,23,95,51,44,9,24,21,21,19,2,0,0,0,0,0,0,3,365,252,37,26,29,21,"Leeds 039B","E01011589"
160,1350,806,779,649,141,508,25,5,20,105,55,50,27,19,14,12,12,0,0,0,0,2,2,0,5,525,370,56,30,52,17,"Leeds 039C","E01011590"
161,1337,891,866,737,134,603,22,4,18,107,41,66,25,9,2,2,1,1,0,0,0,0,0,0,7,437,323,20,26,38,30,"Leeds 039D","E01011592"
162,1603,1072,1053,915,198,717,30,4,26,108,40,68,19,31,24,22,20,2,0,0,0,2,2,0,7,500,376,49,32,18,25,"Leeds 039E","E01011593"
163,1178,638,588,477,130,347,19,6,13,92,45,47,50,29,24,22,11,11,1,1,0,1,1,0,5,511,205,77,100,78,51,"Leeds 040A","E01011421"
164,1211,752,720,580,161,419,22,7,15,118,49,69,32,18,12,12,12,0,0,0,0,0,0,0,6,441,244,52,59,43,43,"Leeds 040B","E01011425"
165,1279,710,639,581,158,423,10,4,6,48,17,31,71,26,20,18,12,6,0,0,0,2,2,0,6,543,220,81,72,121,49,"Leeds 040C","E01011658"
166,1370,879,839,744,201,543,15,5,10,80,29,51,40,24,13,13,12,1,0,0,0,0,0,0,11,467,166,55,80,116,50,"Leeds 040D","E01011660"
167,965,538,470,420,155,265,4,1,3,46,15,31,68,33,17,17,16,1,0,0,0,0,0,0,16,394,86,53,94,107,54,"Leeds 040E","E01011662"
168,1155,705,664,603,173,430,8,3,5,53,8,45,41,16,7,7,7,0,0,0,0,0,0,0,9,434,198,44,77,76,39,"Leeds 041A","E01011721"
169,1588,1029,984,861,221,640,18,3,15,105,37,68,45,32,19,19,17,2,0,0,0,0,0,0,13,527,237,52,86,105,47,"Leeds 041B","E01011722"
170,1269,692,642,583,182,401,5,1,4,54,19,35,50,28,21,21,18,3,0,0,0,0,0,0,7,549,270,55,80,104,40,"Leeds 041C","E01011723"
171,1445,898,835,741,230,511,14,0,14,80,32,48,63,11,10,10,8,2,0,0,0,0,0,0,1,536,239,43,79,109,66,"Leeds 041D","E01011724"
172,1742,1161,1105,934,180,754,18,5,13,153,76,77,56,46,32,30,22,8,0,0,0,2,2,0,14,535,264,76,63,73,59,"Leeds 042A","E01011356"
173,1235,733,657,553,179,374,8,3,5,96,34,62,76,25,12,12,9,3,0,0,0,0,0,0,13,477,206,65,63,86,57,"Leeds 042B","E01011358"
174,1568,984,891,770,206,564,10,5,5,111,56,55,93,45,24,21,17,4,0,0,0,3,3,0,21,539,183,102,86,83,85,"Leeds 042C","E01011359"
175,1688,866,779,609,239,370,27,14,13,143,67,76,87,67,36,32,28,4,0,0,0,4,4,0,31,755,145,195,189,68,158,"Leeds 042D","E01011360"
176,2186,1161,987,822,317,505,25,12,13,140,86,54,174,75,52,51,40,11,0,0,0,1,1,0,23,950,187,268,205,137,153,"Leeds 042E","E01011361"
177,1789,596,543,501,75,426,6,1,5,36,16,20,53,405,281,263,240,23,1,1,0,17,16,1,124,788,62,688,3,23,12,"Leeds 044A","E01011435"
178,1618,597,558,503,105,398,9,4,5,46,17,29,39,353,252,236,208,28,2,2,0,14,13,1,101,668,99,507,5,33,24,"Leeds 044D","E01011440"
179,1842,662,628,547,112,435,14,5,9,67,37,30,34,320,230,204,179,25,2,2,0,24,24,0,90,860,96,637,32,37,58,"Leeds 044E","E01011441"
180,1666,486,442,397,93,304,8,2,6,37,19,18,44,453,321,301,271,30,0,0,0,20,19,1,132,727,37,614,17,26,33,"Leeds 044G","E01035040"
181,1229,400,386,340,66,274,9,3,6,37,17,20,14,275,205,191,166,25,2,2,0,12,10,2,70,554,98,417,6,7,26,"Leeds 044H","E01035041"
182,1677,1008,937,807,184,623,12,3,9,118,67,51,71,92,69,63,45,18,0,0,0,6,6,0,23,577,199,159,78,79,62,"Leeds 045A","E01011477"
183,1419,819,793,667,158,509,18,3,15,108,48,60,26,81,53,50,41,9,0,0,0,3,3,0,28,519,265,127,45,39,43,"Leeds 045B","E01011480"
184,1281,909,859,767,146,621,11,1,10,81,38,43,50,59,45,42,34,8,0,0,0,3,3,0,14,313,112,75,35,52,39,"Leeds 045C","E01011488"
185,1454,855,814,729,158,571,8,3,5,77,34,43,41,61,45,39,27,12,0,0,0,6,6,0,16,538,254,83,78,82,41,"Leeds 045D","E01011489"
186,1438,546,487,445,125,320,6,0,6,36,16,20,59,181,97,93,88,5,1,0,1,3,2,1,84,711,68,419,80,88,56,"Leeds 046A","E01011324"
187,1322,889,830,744,172,572,13,2,11,73,31,42,59,17,12,11,8,3,0,0,0,1,1,0,5,416,233,50,42,55,36,"Leeds 046B","E01011325"
188,1129,673,626,550,133,417,9,1,8,67,24,43,47,21,20,20,14,6,0,0,0,0,0,0,1,435,165,53,59,104,54,"Leeds 046C","E01011326"
189,1194,685,635,565,146,419,3,3,0,67,17,50,50,15,13,13,12,1,0,0,0,0,0,0,2,494,175,56,89,115,59,"Leeds 046D","E01011332"
190,1278,714,662,553,183,370,20,7,13,89,44,45,52,37,19,19,16,3,0,0,0,0,0,0,18,527,176,94,125,64,68,"Leeds 047A","E01011423"
191,1352,759,696,573,184,389,14,5,9,109,55,54,63,50,34,33,29,4,0,0,0,1,1,0,16,543,118,149,147,68,61,"Leeds 047B","E01011424"
192,1386,700,604,492,219,273,22,11,11,90,54,36,96,47,34,32,25,7,0,0,0,2,2,0,13,639,105,146,193,101,94,"Leeds 047C","E01011427"
193,1587,884,793,692,199,493,19,6,13,82,37,45,91,38,24,22,18,4,0,0,0,2,2,0,14,665,146,129,123,187,80,"Leeds 047D","E01011431"
194,1259,672,601,480,165,315,22,10,12,99,52,47,71,55,39,39,32,7,0,0,0,0,0,0,16,532,71,154,151,48,108,"Leeds 048A","E01011422"
195,1242,608,535,446,189,257,22,15,7,67,40,27,73,72,41,38,27,11,0,0,0,3,3,0,31,562,93,146,178,59,86,"Leeds 048B","E01011426"
196,1540,814,737,593,227,366,25,12,13,119,70,49,77,50,33,31,24,7,0,0,0,2,2,0,17,676,106,144,199,64,163,"Leeds 048C","E01011428"
197,1550,720,634,516,225,291,20,9,11,98,56,42,86,60,43,41,34,7,1,0,1,1,1,0,17,770,159,185,213,92,121,"Leeds 048D","E01011429"
198,1168,721,664,596,178,418,13,3,10,55,15,40,57,43,35,32,26,6,0,0,0,3,3,0,8,404,68,81,107,89,59,"Leeds 050A","E01011663"
199,1028,601,569,520,125,395,7,1,6,42,22,20,32,14,12,12,11,1,0,0,0,0,0,0,2,413,195,47,52,82,37,"Leeds 050B","E01011664"
200,1129,658,609,531,157,374,6,0,6,72,22,50,49,10,10,9,7,2,0,0,0,1,1,0,0,461,235,45,46,92,43,"Leeds 050C","E01011665"
201,1047,568,495,442,171,271,7,1,6,46,26,20,73,47,26,25,19,6,0,0,0,1,1,0,21,432,85,95,100,109,43,"Leeds 050D","E01011667"
202,1077,620,594,523,141,382,14,2,12,57,21,36,26,8,5,4,4,0,0,0,0,1,0,1,3,449,262,40,46,61,40,"Leeds 051A","E01011323"
203,1303,854,824,718,164,554,17,6,11,89,22,67,30,22,16,13,9,4,1,0,1,2,0,2,6,427,308,41,19,30,29,"Leeds 051B","E01011329"
204,1106,712,685,585,154,431,12,3,9,88,42,46,27,24,20,17,16,1,1,0,1,2,2,0,4,370,218,49,36,42,25,"Leeds 051C","E01011330"
205,1097,626,600,533,158,375,11,1,10,56,21,35,26,14,6,6,4,2,0,0,0,0,0,0,8,457,237,24,53,105,38,"Leeds 051D","E01011333"
206,1098,655,615,548,131,417,9,1,8,58,25,33,40,7,3,1,1,0,0,0,0,2,1,1,4,436,195,50,40,113,38,"Leeds 052A","E01011327"
207,1256,794,757,643,160,483,15,8,7,99,49,50,37,21,11,10,9,1,0,0,0,1,1,0,10,441,237,46,47,78,33,"Leeds 052B","E01011328"
208,1421,959,910,804,174,630,8,0,8,98,29,69,49,16,13,13,9,4,0,0,0,0,0,0,3,446,262,39,40,57,48,"Leeds 052C","E01011335"
209,1425,1031,1008,894,127,767,15,3,12,99,44,55,23,18,16,11,9,2,0,0,0,5,3,2,2,376,269,32,28,15,32,"Leeds 052D","E01011591"
210,1167,581,517,403,163,240,17,8,9,97,50,47,64,46,32,29,21,8,0,0,0,3,2,1,14,540,77,116,181,38,128,"Leeds 053A","E01011430"
211,1227,616,550,421,167,254,30,12,18,99,53,46,66,35,19,19,16,3,0,0,0,0,0,0,16,576,126,92,158,70,130,"Leeds 053B","E01011432"
212,1317,703,596,490,187,303,21,12,9,85,51,34,107,46,29,26,19,7,0,0,0,3,2,1,17,568,63,117,195,65,128,"Leeds 053C","E01011433"
213,1192,675,584,466,155,311,19,6,13,99,58,41,91,31,22,22,12,10,0,0,0,0,0,0,9,486,60,87,160,59,120,"Leeds 053D","E01011434"
214,1743,195,180,157,34,123,4,2,2,19,13,6,15,401,267,240,213,27,2,2,0,25,23,2,134,1147,13,1088,18,11,17,"Leeds 054A","E01011445"
215,1659,331,306,259,66,193,4,3,1,43,20,23,25,361,276,267,221,46,0,0,0,9,9,0,85,967,46,839,36,12,34,"Leeds 054B","E01011446"
216,1363,248,219,184,53,131,7,0,7,28,18,10,29,313,202,179,160,19,2,2,0,21,20,1,111,802,32,702,17,26,25,"Leeds 054C","E01011447"
217,1565,282,238,200,61,139,4,4,0,34,18,16,44,295,204,181,154,27,0,0,0,23,21,2,91,988,44,827,49,35,33,"Leeds 054D","E01011448"
218,1353,411,376,334,97,237,4,0,4,38,17,21,35,274,208,198,179,19,0,0,0,10,9,1,66,668,21,520,42,35,50,"Leeds 054E","E01011449"
219,2215,594,546,472,167,305,15,5,10,59,32,27,48,281,154,137,125,12,0,0,0,17,17,0,127,1340,192,875,109,106,58,"Leeds 055A","E01011670"
220,1225,564,486,403,148,255,15,7,8,68,29,39,78,74,49,46,32,14,0,0,0,3,1,2,25,587,111,168,120,99,89,"Leeds 055B","E01011671"
221,1668,915,842,749,138,611,17,2,15,76,38,38,73,107,75,66,51,15,1,1,0,8,8,0,32,646,147,262,107,55,75,"Leeds 055F","E01033002"
222,1702,993,889,766,192,574,20,7,13,103,50,53,104,102,62,58,32,26,0,0,0,4,3,1,40,607,57,167,192,66,125,"Leeds 055G","E01033003"
223,2143,293,258,227,70,157,6,0,6,25,16,9,35,359,187,177,154,23,2,2,0,8,7,1,172,1491,66,1282,45,66,32,"Leeds 055I","E01035042"
224,1297,261,227,195,60,135,2,1,1,30,16,14,34,256,167,149,129,20,1,1,0,17,16,1,89,780,27,659,31,34,29,"Leeds 055J","E01035043"
225,1605,924,860,758,162,596,10,4,6,92,42,50,64,192,150,141,119,22,1,1,0,8,7,1,42,489,107,243,36,49,54,"Leeds 056A","E01011478"
226,1478,737,686,612,121,491,9,2,7,65,36,29,51,242,174,160,126,34,0,0,0,14,13,1,68,499,37,399,10,6,47,"Leeds 056B","E01011479"
227,1608,631,584,504,127,377,10,4,6,70,39,31,47,256,186,164,144,20,0,0,0,22,20,2,70,721,77,461,67,54,62,"Leeds 056C","E01011481"
228,1596,1106,1044,937,160,777,10,2,8,97,44,53,62,97,80,74,54,20,0,0,0,6,6,0,17,393,106,156,29,33,69,"Leeds 056D","E01011482"
229,1436,599,528,455,128,327,11,3,8,62,23,39,71,175,125,109,101,8,1,1,0,15,14,1,50,662,108,343,76,72,63,"Leeds 056E","E01011483"
230,1106,695,672,591,120,471,10,4,6,71,25,46,23,18,14,13,11,2,0,0,0,1,1,0,4,393,312,22,25,17,17,"Leeds 057A","E01011406"
231,1196,736,705,596,155,441,15,3,12,94,37,57,31,16,14,14,13,1,0,0,0,0,0,0,2,444,304,51,32,37,20,"Leeds 057B","E01011407"
232,1332,658,642,574,145,429,9,0,9,59,22,37,16,22,19,16,11,5,0,0,0,3,1,2,3,652,562,19,13,34,24,"Leeds 057C","E01011408"
233,1228,755,711,598,129,469,19,4,15,94,35,59,44,30,22,20,15,5,0,0,0,2,1,1,8,443,290,41,33,58,21,"Leeds 057D","E01011409"
234,1406,814,793,684,164,520,16,1,15,93,36,57,21,13,12,11,10,1,0,0,0,1,0,1,1,579,473,30,26,34,16,"Leeds 057E","E01011410"
235,1497,908,880,770,182,588,20,0,20,90,27,63,28,25,18,15,12,3,0,0,0,3,2,1,7,564,424,40,44,33,23,"Leeds 057F","E01011412"
236,1121,745,711,618,138,480,10,3,7,83,40,43,34,26,22,21,17,4,0,0,0,1,1,0,4,350,208,32,39,46,25,"Leeds 058A","E01011331"
237,1190,796,758,684,145,539,8,0,8,66,28,38,38,25,15,15,12,3,0,0,0,0,0,0,10,369,149,58,42,64,56,"Leeds 058B","E01011334"
238,1328,760,709,622,159,463,16,8,8,71,29,42,51,17,11,11,10,1,0,0,0,0,0,0,6,551,295,35,54,105,62,"Leeds 058C","E01011336"
239,1165,688,639,568,174,394,10,3,7,61,22,39,49,31,27,27,20,7,0,0,0,0,0,0,4,446,86,95,110,105,50,"Leeds 058D","E01011337"
240,1722,1110,1040,904,205,699,29,8,21,107,48,59,70,45,28,28,20,8,0,0,0,0,0,0,17,567,245,74,94,96,58,"Leeds 059A","E01011281"
241,1090,655,612,555,136,419,6,1,5,51,20,31,43,32,20,19,15,4,0,0,0,1,1,0,12,403,154,65,57,86,41,"Leeds 059B","E01011282"
242,1121,629,576,512,155,357,6,2,4,58,31,27,53,25,22,22,20,2,0,0,0,0,0,0,3,467,128,68,98,103,70,"Leeds 059C","E01011283"
243,1056,695,670,587,133,454,11,0,11,72,29,43,25,21,16,14,11,3,0,0,0,2,2,0,5,340,186,37,39,45,33,"Leeds 059D","E01011286"
244,1299,858,794,706,182,524,3,1,2,85,42,43,64,19,15,13,10,3,0,0,0,2,1,1,4,422,133,67,71,93,58,"Leeds 059E","E01011295"
245,1602,888,815,711,212,499,18,5,13,86,41,45,73,48,36,33,28,5,2,2,0,1,1,0,12,666,288,99,87,126,66,"Leeds 060A","E01011339"
246,1310,687,598,536,160,376,13,2,11,49,26,23,89,40,25,23,16,7,0,0,0,2,2,0,15,583,235,85,105,99,59,"Leeds 060B","E01011340"
247,1307,730,641,563,183,380,15,3,12,63,31,32,89,30,22,18,11,7,1,1,0,3,2,1,8,547,126,142,113,71,95,"Leeds 060C","E01011342"
248,1454,773,693,586,188,398,13,6,7,94,29,65,80,78,64,53,41,12,0,0,0,11,3,8,14,603,223,106,91,141,42,"Leeds 060D","E01011346"
249,1669,1128,1092,973,222,751,19,5,14,100,33,67,36,24,18,18,12,6,0,0,0,0,0,0,6,517,221,93,87,60,56,"Leeds 061A","E01011341"
250,1671,1100,1036,918,195,723,9,3,6,109,33,76,64,36,25,23,16,7,0,0,0,2,2,0,11,535,237,44,63,120,71,"Leeds 061B","E01011343"
251,1181,696,642,581,135,446,12,2,10,49,14,35,54,30,24,23,21,2,0,0,0,1,1,0,6,455,233,58,56,72,36,"Leeds 061C","E01011345"
252,1206,755,725,644,143,501,10,3,7,71,21,50,30,22,15,13,13,0,0,0,0,2,2,0,7,429,294,39,46,14,36,"Leeds 061D","E01011666"
253,1147,713,670,596,146,450,3,0,3,71,28,43,43,26,19,19,16,3,0,0,0,0,0,0,7,408,243,60,32,51,22,"Leeds 062A","E01011585"
254,1396,990,966,838,161,677,20,6,14,108,54,54,24,26,18,17,14,3,0,0,0,1,1,0,8,380,229,51,28,29,43,"Leeds 062B","E01011587"
255,1199,766,727,619,172,447,24,3,21,84,39,45,39,10,5,5,3,2,0,0,0,0,0,0,5,423,232,52,46,72,21,"Leeds 062C","E01011594"
256,1384,932,903,803,189,614,29,8,21,71,25,46,29,14,12,12,9,3,0,0,0,0,0,0,2,438,325,39,23,21,30,"Leeds 062D","E01011596"
257,1358,929,915,802,159,643,9,0,9,104,41,63,14,32,24,22,15,7,0,0,0,2,1,1,8,397,264,35,31,31,36,"Leeds 062E","E01011598"
258,4215,575,536,488,86,402,4,3,1,44,23,21,39,962,489,454,400,54,0,0,0,35,35,0,473,2678,50,2497,38,42,51,"Leeds 063B","E01011678"
259,1449,450,380,337,100,237,6,1,5,37,19,18,70,196,130,117,101,16,4,3,1,9,9,0,66,803,80,464,90,95,74,"Leeds 063D","E01011681"
260,2571,350,318,285,66,219,4,1,3,29,12,17,32,445,280,246,207,39,3,3,0,31,31,0,165,1776,32,1672,25,31,16,"Leeds 063F","E01035044"
261,1251,486,465,441,60,381,4,0,4,20,11,9,21,121,85,81,60,21,0,0,0,4,4,0,36,644,39,555,20,16,14,"Leeds 063G","E01035045"
262,1478,813,728,592,178,414,14,4,10,122,44,78,85,46,29,25,12,13,1,1,0,3,1,2,17,619,159,116,128,130,86,"Leeds 064A","E01011338"
263,1360,758,642,532,176,356,14,8,6,96,63,33,116,42,31,28,16,12,1,0,1,2,2,0,11,560,83,163,141,67,106,"Leeds 064B","E01011673"
264,1261,666,558,472,139,333,19,9,10,67,39,28,108,29,23,20,13,7,0,0,0,3,2,1,6,566,125,87,115,138,101,"Leeds 064D","E01011677"
265,1385,812,758,685,118,567,18,5,13,55,21,34,54,68,43,38,29,9,0,0,0,5,4,1,25,505,91,172,69,48,125,"Leeds 064E","E01033031"
266,1181,613,517,399,169,230,38,27,11,80,38,42,96,32,25,22,20,2,0,0,0,3,2,1,7,536,49,93,191,88,115,"Leeds 064F","E01033035"
267,1448,767,676,580,157,423,27,11,16,69,36,33,91,42,23,23,15,8,0,0,0,0,0,0,19,639,99,160,192,76,112,"Leeds 065A","E01011344"
268,1422,763,668,582,210,372,10,2,8,76,35,41,95,31,15,14,12,2,0,0,0,1,0,1,16,628,84,242,144,85,73,"Leeds 065B","E01011347"
269,1274,731,621,539,163,376,11,4,7,71,33,38,110,53,42,41,29,12,1,1,0,0,0,0,11,490,126,118,122,74,50,"Leeds 065C","E01011348"
270,1429,766,674,588,202,386,16,6,10,70,32,38,92,23,16,16,11,5,0,0,0,0,0,0,7,640,251,76,111,123,79,"Leeds 065D","E01011349"
271,1411,872,830,726,192,534,16,6,10,88,42,46,42,22,19,18,14,4,0,0,0,1,1,0,3,517,293,71,67,46,40,"Leeds 066A","E01011586"
272,1743,1044,1009,807,185,622,58,12,46,144,55,89,35,35,28,22,19,3,0,0,0,6,6,0,7,664,372,103,85,48,56,"Leeds 066B","E01011595"
273,1307,744,702,622,180,442,11,5,6,69,22,47,42,23,20,19,16,3,0,0,0,1,1,0,3,540,244,83,116,47,50,"Leeds 066C","E01011597"
274,1348,891,866,766,189,577,13,4,9,87,32,55,25,12,8,8,6,2,0,0,0,0,0,0,4,445,271,49,59,39,27,"Leeds 066D","E01011599"
275,1197,725,689,620,141,479,8,2,6,61,25,36,36,25,17,12,10,2,0,0,0,5,0,5,8,447,277,49,52,30,39,"Leeds 067B","E01011287"
276,1443,875,843,708,180,528,19,1,18,116,42,74,32,33,23,20,17,3,1,0,1,2,1,1,10,535,327,58,65,47,38,"Leeds 067G","E01032499"
277,1132,685,615,542,120,422,9,5,4,64,19,45,70,48,27,26,23,3,0,0,0,1,1,0,21,399,161,53,44,61,80,"Leeds 067H","E01032500"
278,1683,1114,1048,945,232,713,9,2,7,94,34,60,66,21,16,15,12,3,0,0,0,1,1,0,5,548,281,60,71,83,53,"Leeds 067I","E01032606"
279,1104,695,641,571,118,453,13,1,12,57,25,32,54,20,15,13,8,5,0,0,0,2,2,0,5,389,183,49,45,66,46,"Leeds 067J","E01032607"
280,963,635,588,517,122,395,13,5,8,58,13,45,47,22,15,14,11,3,0,0,0,1,1,0,7,306,133,41,38,54,40,"Leeds 067K","E01032608"
281,1100,649,617,524,138,386,14,4,10,79,27,52,32,17,14,11,11,0,0,0,0,3,2,1,3,434,258,53,51,35,37,"Leeds 068A","E01011608"
282,1141,680,639,573,162,411,8,2,6,58,24,34,41,15,12,11,8,3,0,0,0,1,1,0,3,446,212,73,48,76,37,"Leeds 068B","E01011609"
283,1284,803,786,696,158,538,10,3,7,80,28,52,17,29,24,22,17,5,0,0,0,2,0,2,5,452,292,45,33,49,33,"Leeds 068C","E01011610"
284,1137,667,610,541,157,384,4,2,2,65,29,36,57,9,5,5,5,0,0,0,0,0,0,0,4,461,179,56,77,102,47,"Leeds 068D","E01011611"
285,1587,1036,1000,871,178,693,17,3,14,112,46,66,36,27,15,15,12,3,0,0,0,0,0,0,12,524,377,52,29,42,24,"Leeds 068E","E01011614"
286,1229,803,784,669,169,500,17,3,14,98,32,66,19,19,18,17,12,5,0,0,0,1,1,0,1,407,285,51,34,22,15,"Leeds 069A","E01011413"
287,1368,821,797,699,151,548,10,0,10,88,30,58,24,35,26,15,11,4,0,0,0,11,11,0,9,512,346,81,33,28,24,"Leeds 069B","E01011415"
288,1212,799,770,645,163,482,20,6,14,105,39,66,29,17,12,12,9,3,0,0,0,0,0,0,5,396,248,56,36,32,24,"Leeds 069C","E01011416"
289,1338,706,685,583,157,426,17,3,14,85,28,57,21,29,20,17,13,4,1,1,0,2,2,0,9,603,479,30,31,38,25,"Leeds 069D","E01011417"
290,1204,569,553,476,112,364,10,4,6,67,26,41,16,17,12,11,10,1,1,1,0,0,0,0,5,618,527,33,13,31,14,"Leeds 069E","E01011420"
291,1254,793,720,622,157,465,17,6,11,81,30,51,73,17,12,12,8,4,0,0,0,0,0,0,5,444,218,61,53,45,67,"Leeds 070A","E01011615"
292,1254,720,658,587,190,397,7,2,5,64,26,38,62,23,19,18,15,3,0,0,0,1,1,0,4,511,182,70,88,118,53,"Leeds 070B","E01011617"
293,1256,766,703,640,189,451,2,0,2,61,24,37,63,36,23,21,14,7,0,0,0,2,1,1,13,454,153,109,83,58,51,"Leeds 070C","E01011618"
294,1150,614,559,493,156,337,12,5,7,54,22,32,55,40,28,26,20,6,1,0,1,1,1,0,12,496,166,85,90,91,64,"Leeds 070D","E01011621"
295,1753,1199,1115,988,176,812,12,3,9,115,51,64,84,77,70,68,39,29,0,0,0,2,2,0,7,477,101,88,99,98,91,"Leeds 071A","E01011284"
296,1524,822,712,620,149,471,16,6,10,76,39,37,110,37,30,28,19,9,0,0,0,2,1,1,7,665,197,114,108,128,118,"Leeds 071B","E01011292"
297,1484,920,828,703,195,508,23,9,14,102,55,47,92,38,27,21,15,6,0,0,0,6,4,2,11,526,134,75,134,97,86,"Leeds 071C","E01011293"
298,1452,508,439,384,129,255,10,5,5,45,23,22,69,21,12,11,6,5,1,1,0,0,0,0,9,923,117,82,73,145,506,"Leeds 071D","E01011294"
299,1501,884,805,708,173,535,20,9,11,77,25,52,79,39,31,29,24,5,0,0,0,2,2,0,8,578,143,105,138,101,91,"Leeds 071E","E01011363"
300,1239,698,645,555,157,398,13,5,8,77,28,49,53,19,18,17,15,2,0,0,0,1,0,1,1,522,231,57,82,106,46,"Leeds 072A","E01011616"
301,991,573,511,432,165,267,11,0,11,68,26,42,62,25,11,11,8,3,0,0,0,0,0,0,14,393,161,54,65,74,39,"Leeds 072B","E01011620"
302,1264,711,646,589,194,395,10,5,5,47,14,33,65,49,37,32,20,12,0,0,0,5,2,3,12,504,112,110,121,110,51,"Leeds 072C","E01011622"
303,1320,753,671,598,168,430,7,1,6,66,16,50,82,40,31,30,23,7,0,0,0,1,1,0,9,527,162,93,104,100,68,"Leeds 072D","E01011624"
304,1436,940,914,773,184,589,25,3,22,116,43,73,26,29,26,26,23,3,0,0,0,0,0,0,3,467,328,45,52,20,22,"Leeds 073A","E01011411"
305,1262,799,779,677,155,522,20,4,16,82,27,55,20,14,11,10,7,3,0,0,0,1,1,0,3,449,330,46,26,18,29,"Leeds 073B","E01011414"
306,1225,741,721,627,127,500,15,7,8,79,35,44,20,23,19,18,17,1,0,0,0,1,1,0,4,461,355,16,31,36,23,"Leeds 073C","E01011418"
307,973,517,504,431,115,316,8,2,6,65,29,36,13,13,8,7,4,3,0,0,0,1,1,0,5,443,383,24,15,15,6,"Leeds 073D","E01011419"
308,1581,950,908,791,188,603,22,3,19,95,39,56,42,65,46,44,42,2,0,0,0,2,1,1,19,566,333,124,37,49,23,"Leeds 074A","E01011396"
309,1235,751,722,635,168,467,13,2,11,74,35,39,29,23,18,18,17,1,0,0,0,0,0,0,5,461,334,46,27,39,15,"Leeds 074B","E01011399"
310,1165,666,639,558,133,425,7,2,5,74,20,54,27,22,11,11,9,2,0,0,0,0,0,0,11,477,329,41,33,54,20,"Leeds 074C","E01011400"
311,1348,595,587,512,131,381,13,3,10,62,27,35,8,27,21,21,20,1,0,0,0,0,0,0,6,726,631,31,14,30,20,"Leeds 074D","E01011403"
312,1259,641,560,503,185,318,10,5,5,47,18,29,81,66,41,38,34,4,0,0,0,3,3,0,25,552,125,165,113,81,68,"Leeds 075B","E01011623"
313,1251,746,656,586,192,394,10,5,5,60,18,42,90,30,25,21,16,5,0,0,0,4,3,1,5,475,169,72,118,66,50,"Leeds 075C","E01011625"
314,1850,1210,1131,1020,217,803,32,8,24,79,29,50,79,61,44,43,30,13,0,0,0,1,1,0,17,579,167,134,99,107,72,"Leeds 075D","E01011626"
315,1770,1141,1062,972,198,774,20,9,11,70,28,42,79,31,20,19,14,5,0,0,0,1,1,0,11,598,200,112,68,143,75,"Leeds 075E","E01033021"
316,1500,771,733,686,64,622,4,2,2,43,18,25,38,185,98,83,73,10,1,1,0,14,14,0,87,544,85,344,46,37,32,"Leeds 075F","E01033033"
317,1428,1257,1233,1139,71,1068,17,2,15,77,22,55,24,56,52,46,26,20,0,0,0,6,4,2,4,115,22,55,9,8,21,"Leeds 075G","E01033034"
318,1618,915,893,767,175,592,13,0,13,113,54,59,22,15,11,10,10,0,0,0,0,1,0,1,4,688,514,60,36,55,23,"Leeds 076A","E01011602"
319,1305,808,783,667,164,503,22,4,18,94,42,52,25,13,7,6,2,4,1,0,1,0,0,0,6,484,341,54,36,30,23,"Leeds 076B","E01011603"
320,1429,873,861,772,197,575,14,1,13,75,30,45,12,23,14,13,13,0,0,0,0,1,0,1,9,533,386,62,30,24,31,"Leeds 076C","E01011605"
321,1593,962,916,778,204,574,22,9,13,116,45,71,46,29,19,18,12,6,0,0,0,1,1,0,10,602,309,88,90,72,43,"Leeds 076D","E01011606"
322,1312,882,831,752,182,570,13,3,10,66,29,37,51,11,5,5,5,0,0,0,0,0,0,0,6,419,196,56,73,49,45,"Leeds 076E","E01011613"
323,1211,739,717,641,175,466,9,1,8,67,28,39,22,20,9,9,8,1,0,0,0,0,0,0,11,452,348,36,26,29,13,"Leeds 077A","E01011397"
324,977,621,607,548,125,423,13,4,9,46,14,32,14,13,11,11,8,3,0,0,0,0,0,0,2,343,274,32,7,16,14,"Leeds 077B","E01011398"
325,1417,902,883,790,175,615,18,6,12,75,37,38,19,26,16,15,11,4,0,0,0,1,1,0,10,489,363,46,36,22,22,"Leeds 077C","E01011401"
326,1114,676,657,580,141,439,11,0,11,66,19,47,19,24,14,14,12,2,0,0,0,0,0,0,10,414,316,38,26,20,14,"Leeds 077D","E01011404"
327,1266,580,568,479,119,360,10,2,8,79,37,42,12,12,7,6,6,0,0,0,0,1,1,0,5,674,549,39,35,33,18,"Leeds 077E","E01011405"
328,1111,631,566,506,177,329,12,0,12,48,17,31,65,36,28,25,19,6,0,0,0,3,3,0,8,444,114,64,90,128,48,"Leeds 078A","E01011725"
329,1388,804,714,648,161,487,14,3,11,52,18,34,90,23,16,16,15,1,0,0,0,0,0,0,7,561,252,64,82,116,47,"Leeds 078B","E01011729"
330,1151,739,664,598,153,445,7,2,5,59,24,35,75,23,11,10,6,4,1,1,0,0,0,0,12,389,128,55,76,91,39,"Leeds 078C","E01011730"
331,1256,708,656,594,170,424,6,0,6,56,14,42,52,25,21,19,15,4,0,0,0,2,1,1,4,523,211,60,91,116,45,"Leeds 078D","E01011735"
332,1293,789,765,665,121,544,13,0,13,87,30,57,24,18,14,13,11,2,0,0,0,1,0,1,4,486,355,45,32,34,20,"Leeds 079A","E01011600"
333,1252,833,797,697,159,538,22,5,17,78,29,49,36,16,8,7,7,0,0,0,0,1,1,0,8,403,192,64,60,47,40,"Leeds 079B","E01011601"
334,1136,744,720,630,130,500,17,3,14,73,32,41,24,17,15,13,12,1,0,0,0,2,2,0,2,375,254,53,27,23,18,"Leeds 079C","E01011604"
335,1306,860,823,719,173,546,18,6,12,86,28,58,37,27,25,25,16,9,0,0,0,0,0,0,2,419,241,53,48,43,34,"Leeds 079D","E01011607"
336,1234,634,614,529,136,393,13,0,13,72,32,40,20,10,6,6,6,0,0,0,0,0,0,0,4,590,401,32,27,70,60,"Leeds 079E","E01011612"
337,1174,697,641,549,161,388,16,3,13,76,25,51,56,21,8,8,6,2,0,0,0,0,0,0,13,456,211,37,87,74,47,"Leeds 080A","E01011726"
338,1278,830,797,674,160,514,25,8,17,98,49,49,33,23,14,14,9,5,0,0,0,0,0,0,9,425,255,61,35,44,30,"Leeds 080B","E01011727"
339,1188,703,673,547,133,414,29,4,25,97,37,60,30,23,18,18,12,6,0,0,0,0,0,0,5,462,359,33,18,21,31,"Leeds 080C","E01011728"
340,1279,724,670,586,170,416,11,3,8,73,28,45,54,21,12,12,8,4,0,0,0,0,0,0,9,534,209,58,73,128,66,"Leeds 080D","E01011739"
341,1588,1003,825,730,174,556,14,7,7,81,36,45,178,35,19,17,12,5,0,0,0,2,2,0,16,550,185,74,98,122,71,"Leeds 081A","E01011362"
342,1186,703,685,602,141,461,14,5,9,69,27,42,18,22,14,13,12,1,0,0,0,1,1,0,8,461,310,45,46,33,27,"Leeds 081B","E01011731"
343,1640,1064,1001,887,191,696,20,2,18,94,33,61,63,20,14,13,8,5,0,0,0,1,1,0,6,556,292,69,64,87,44,"Leeds 081C","E01011732"
344,1331,808,773,666,151,515,16,5,11,91,33,58,35,24,18,13,12,1,0,0,0,5,5,0,6,499,348,38,36,44,33,"Leeds 081D","E01011733"
345,1347,815,722,633,177,456,5,2,3,84,43,41,93,36,22,21,12,9,0,0,0,1,0,1,14,496,139,97,103,90,67,"Leeds 082A","E01011366"
346,1233,718,632,549,173,376,15,2,13,68,31,37,86,48,33,32,25,7,0,0,0,1,1,0,15,467,75,93,117,82,100,"Leeds 082C","E01011368"
347,1338,750,687,576,159,417,14,7,7,97,41,56,63,37,30,25,20,5,0,0,0,5,5,0,7,551,197,70,93,106,85,"Leeds 082D","E01011370"
348,1187,745,695,639,109,530,11,5,6,45,17,28,50,49,41,39,22,17,0,0,0,2,2,0,8,393,103,116,55,64,55,"Leeds 082E","E01033013"
349,1110,939,906,858,37,821,1,1,0,47,14,33,33,50,38,36,24,12,0,0,0,2,2,0,12,121,1,79,24,7,10,"Leeds 082G","E01035046"
350,1067,774,731,658,140,518,9,3,6,64,20,44,43,45,35,29,25,4,0,0,0,6,4,2,10,248,61,66,52,28,41,"Leeds 082H","E01035047"
351,2225,1677,1630,1461,271,1190,24,2,22,145,51,94,47,37,30,30,22,8,0,0,0,0,0,0,7,511,273,67,65,43,63,"Leeds 083A","E01011734"
352,1178,736,707,599,131,468,14,6,8,94,37,57,29,18,14,14,13,1,0,0,0,0,0,0,4,424,281,49,24,39,31,"Leeds 083B","E01011736"
353,1245,736,684,612,139,473,11,2,9,61,17,44,52,15,10,9,9,0,1,0,1,0,0,0,5,494,248,42,70,80,54,"Leeds 083C","E01011737"
354,1236,760,720,621,130,491,18,6,12,81,33,48,40,23,17,15,12,3,1,0,1,1,1,0,6,453,318,43,27,43,22,"Leeds 083D","E01011738"
355,1589,977,910,808,202,606,14,4,10,88,34,54,67,46,36,34,24,10,0,0,0,2,2,0,10,566,146,118,121,127,54,"Leeds 085A","E01011364"
356,1356,714,640,548,206,342,30,9,21,62,27,35,74,48,35,33,25,8,0,0,0,2,2,0,13,594,243,85,82,122,62,"Leeds 085B","E01011371"
357,1110,641,566,481,170,311,18,7,11,67,32,35,75,41,30,28,20,8,0,0,0,2,2,0,11,428,70,102,109,88,59,"Leeds 085C","E01011373"
358,992,648,577,524,146,378,9,3,6,44,19,25,71,40,28,27,22,5,0,0,0,1,1,0,12,304,80,56,54,74,40,"Leeds 085D","E01011374"
359,1416,730,659,563,198,365,11,6,5,85,33,52,71,54,37,36,31,5,0,0,0,1,1,0,17,632,81,137,210,94,110,"Leeds 086A","E01011312"
360,1447,809,724,612,230,382,32,12,20,80,38,42,85,54,36,34,27,7,0,0,0,2,2,0,18,584,79,140,160,73,132,"Leeds 086B","E01011316"
361,1240,673,583,491,197,294,12,3,9,80,44,36,90,82,67,65,51,14,0,0,0,2,1,1,15,485,51,114,117,94,109,"Leeds 086C","E01011372"
362,1479,801,690,575,215,360,28,8,20,87,42,45,111,34,23,22,14,8,0,0,0,1,1,0,11,644,70,148,206,82,138,"Leeds 086D","E01011375"
363,1138,685,658,569,147,422,5,0,5,84,28,56,27,12,9,7,6,1,2,0,2,0,0,0,3,441,279,38,31,72,21,"Leeds 087A","E01011390"
364,1331,660,624,547,141,406,16,6,10,61,28,33,36,14,10,10,7,3,0,0,0,0,0,0,4,657,471,42,39,66,39,"Leeds 087B","E01011391"
365,1546,934,907,792,180,612,26,6,20,89,36,53,27,20,12,12,10,2,0,0,0,0,0,0,8,592,429,47,40,51,25,"Leeds 087C","E01011392"
366,1738,896,866,730,201,529,30,2,28,106,41,65,30,19,14,14,12,2,0,0,0,0,0,0,5,823,594,63,41,61,64,"Leeds 087D","E01011402"
367,1251,745,714,635,139,496,12,2,10,67,19,48,31,19,16,16,12,4,0,0,0,0,0,0,3,487,260,48,58,84,37,"Leeds 088A","E01011298"
368,2174,1491,1450,1237,297,940,38,6,32,175,72,103,41,28,22,22,19,3,0,0,0,0,0,0,6,655,401,76,62,62,54,"Leeds 088B","E01011299"
369,1531,801,793,690,168,522,15,4,11,88,41,47,8,21,16,15,13,2,1,0,1,0,0,0,5,709,596,33,29,23,28,"Leeds 088C","E01011302"
370,953,547,525,471,129,342,5,2,3,49,14,35,22,13,11,10,10,0,1,1,0,0,0,0,2,393,289,28,27,26,23,"Leeds 088D","E01011303"
371,1162,685,658,589,145,444,10,2,8,59,28,31,27,15,11,11,10,1,0,0,0,0,0,0,4,462,280,38,48,73,23,"Leeds 089A","E01011300"
372,1058,621,599,531,138,393,13,2,11,55,25,30,22,10,7,6,5,1,0,0,0,1,1,0,3,427,353,22,19,20,13,"Leeds 089B","E01011301"
373,1264,720,677,594,154,440,10,5,5,73,25,48,43,25,14,13,13,0,0,0,0,1,0,1,11,519,274,59,55,91,40,"Leeds 089C","E01011304"
374,1232,834,804,691,161,530,18,2,16,95,42,53,30,12,10,9,9,0,0,0,0,1,1,0,2,386,267,31,28,33,27,"Leeds 089D","E01011305"
375,1093,688,668,573,139,434,10,0,10,85,32,53,20,22,18,17,12,5,0,0,0,1,1,0,4,383,280,41,20,18,24,"Leeds 089E","E01011306"
376,1260,777,735,640,178,462,19,5,14,76,33,43,42,20,17,16,13,3,1,1,0,0,0,0,3,463,214,60,75,66,48,"Leeds 090A","E01011315"
377,1393,733,669,574,159,415,20,4,16,75,31,44,64,38,34,33,30,3,0,0,0,1,1,0,4,622,254,63,90,142,73,"Leeds 090B","E01011317"
378,1123,663,591,514,158,356,13,3,10,64,34,30,72,20,14,13,13,0,0,0,0,1,1,0,6,440,119,70,118,78,55,"Leeds 090C","E01011318"
379,1240,724,672,595,184,411,3,1,2,74,35,39,52,36,26,24,18,6,1,1,0,1,1,0,10,480,158,62,100,103,57,"Leeds 090D","E01011321"
380,1307,781,759,681,166,515,15,4,11,63,26,37,22,22,15,15,14,1,0,0,0,0,0,0,7,504,287,42,57,66,52,"Leeds 090E","E01011369"
381,1272,825,764,672,169,503,12,5,7,80,27,53,61,39,25,24,17,7,0,0,0,1,1,0,14,408,126,73,97,52,60,"Leeds 091A","E01011313"
382,1239,816,775,667,159,508,19,8,11,89,45,44,41,36,27,25,13,12,0,0,0,2,1,1,9,387,153,60,81,40,53,"Leeds 091B","E01011314"
383,1215,699,658,538,158,380,12,3,9,108,59,49,41,37,30,20,18,2,0,0,0,10,10,0,7,479,191,70,97,54,67,"Leeds 091C","E01011319"
384,1408,862,814,676,189,487,30,7,23,108,43,65,48,32,19,19,16,3,0,0,0,0,0,0,13,514,269,67,97,38,43,"Leeds 091D","E01011320"
385,1275,726,694,586,164,422,16,4,12,92,34,58,32,21,12,12,7,5,0,0,0,0,0,0,9,528,312,56,69,48,43,"Leeds 091E","E01011322"
386,1186,672,594,524,150,374,22,12,10,48,21,27,78,33,27,26,23,3,0,0,0,1,1,0,6,481,170,54,91,120,46,"Leeds 092A","E01011471"
387,1297,691,635,538,165,373,19,10,9,78,30,48,56,19,13,12,10,2,1,1,0,0,0,0,6,587,236,55,91,137,68,"Leeds 092B","E01011472"
388,1113,622,554,505,164,341,5,1,4,44,16,28,68,57,47,47,36,11,0,0,0,0,0,0,10,434,98,83,92,96,65,"Leeds 092C","E01011473"
389,1194,695,622,566,173,393,17,1,16,39,13,26,73,26,21,21,19,2,0,0,0,0,0,0,5,473,166,55,94,99,59,"Leeds 092D","E01011474"
390,1852,1334,1274,1116,218,898,17,3,14,141,51,90,60,25,22,21,16,5,0,0,0,1,1,0,3,493,284,66,49,62,32,"Leeds 093A","E01011518"
391,1049,658,642,547,127,420,12,1,11,83,26,57,16,30,18,17,14,3,0,0,0,1,1,0,12,361,283,19,16,25,18,"Leeds 093B","E01011524"
392,1036,713,695,611,132,479,15,4,11,69,30,39,18,30,25,25,22,3,0,0,0,0,0,0,5,293,209,40,24,10,10,"Leeds 093C","E01011526"
393,1432,728,709,619,150,469,15,3,12,75,29,46,19,16,8,8,6,2,0,0,0,0,0,0,8,688,586,25,28,34,15,"Leeds 093D","E01011531"
394,1236,690,645,564,157,407,11,1,10,70,25,45,45,18,12,11,6,5,0,0,0,1,1,0,6,528,280,46,58,99,45,"Leeds 094A","E01011466"
395,1198,705,673,577,131,446,11,2,9,85,30,55,32,14,11,11,9,2,0,0,0,0,0,0,3,479,313,34,53,42,37,"Leeds 094B","E01011469"
396,1209,709,637,579,197,382,6,2,4,52,14,38,72,29,18,18,15,3,0,0,0,0,0,0,11,471,160,64,84,96,67,"Leeds 094C","E01011475"
397,896,526,480,439,118,321,4,1,3,37,13,24,46,18,13,13,11,2,0,0,0,0,0,0,5,352,151,43,66,54,38,"Leeds 094D","E01011476"
398,1221,744,705,611,155,456,14,0,14,80,33,47,39,18,12,12,10,2,0,0,0,0,0,0,6,459,240,43,41,81,54,"Leeds 095A","E01011519"
399,1153,674,662,581,138,443,19,5,14,62,26,36,12,20,18,18,15,3,0,0,0,0,0,0,2,459,372,34,17,14,22,"Leeds 095B","E01011522"
400,1261,806,786,688,162,526,17,6,11,81,25,56,20,12,10,9,8,1,1,1,0,0,0,0,2,443,297,34,27,47,38,"Leeds 095C","E01011525"
401,1294,882,859,741,172,569,31,4,27,87,33,54,23,22,18,18,16,2,0,0,0,0,0,0,4,390,240,59,32,27,32,"Leeds 095D","E01011528"
402,1289,802,745,671,188,483,20,3,17,54,19,35,57,18,17,16,13,3,1,1,0,0,0,0,1,469,231,44,54,96,44,"Leeds 095E","E01011532"
403,1270,721,696,588,142,446,17,6,11,91,33,58,25,18,17,16,13,3,0,0,0,1,0,1,1,531,407,34,34,34,22,"Leeds 096A","E01011520"
404,1808,1156,1111,933,232,701,38,9,29,140,55,85,45,26,16,16,15,1,0,0,0,0,0,0,10,626,454,44,37,50,41,"Leeds 096B","E01011521"
405,1512,907,885,761,178,583,8,1,7,116,57,59,22,24,17,16,15,1,0,0,0,1,1,0,7,581,377,42,50,65,47,"Leeds 096C","E01011523"
406,1473,849,828,707,181,526,21,5,16,100,40,60,21,16,12,10,10,0,0,0,0,2,2,0,4,608,470,47,27,32,32,"Leeds 096D","E01011527"
407,1098,638,608,523,145,378,19,4,15,66,17,49,30,22,19,19,14,5,0,0,0,0,0,0,3,438,259,35,51,64,29,"Leeds 096E","E01011529"
408,1537,902,859,725,134,591,25,3,22,109,46,63,43,27,18,14,13,1,2,1,1,2,1,1,9,608,393,64,42,42,67,"Leeds 097B","E01011635"
409,1364,901,867,759,178,581,17,3,14,91,35,56,34,15,14,13,10,3,0,0,0,1,1,0,1,448,282,54,35,44,33,"Leeds 097C","E01011637"
410,1191,709,688,610,147,463,11,3,8,67,26,41,21,20,15,15,14,1,0,0,0,0,0,0,5,462,341,47,29,34,11,"Leeds 097D","E01011638"
411,826,444,430,374,101,273,12,3,9,44,19,25,14,18,11,11,6,5,0,0,0,0,0,0,7,364,207,36,37,60,24,"Leeds 097F","E01032487"
412,1481,881,856,729,179,550,21,2,19,106,44,62,25,17,12,10,4,6,1,0,1,1,0,1,5,583,433,46,31,52,21,"Leeds 097G","E01032488"
413,1077,572,536,475,148,327,13,1,12,48,22,26,36,12,5,3,3,0,0,0,0,2,2,0,7,493,319,36,53,60,25,"Leeds 098A","E01011627"
414,1068,587,573,500,105,395,13,3,10,60,19,41,14,20,13,13,12,1,0,0,0,0,0,0,7,461,395,21,16,15,14,"Leeds 098B","E01011628"
415,1088,649,622,545,126,419,10,2,8,67,25,42,27,13,10,10,9,1,0,0,0,0,0,0,3,426,255,35,35,80,21,"Leeds 098C","E01011629"
416,1017,596,567,505,134,371,5,1,4,57,13,44,29,17,14,14,13,1,0,0,0,0,0,0,3,404,167,36,75,91,35,"Leeds 098D","E01011632"
417,1239,724,697,601,141,460,22,11,11,74,36,38,27,16,12,12,12,0,0,0,0,0,0,0,4,499,377,32,25,46,19,"Leeds 098E","E01011633"
418,1090,645,605,527,143,384,9,1,8,69,16,53,40,13,10,9,6,3,0,0,0,1,1,0,3,432,230,37,62,66,37,"Leeds 099C","E01011502"
419,1177,691,633,559,166,393,13,2,11,61,23,38,58,23,13,12,8,4,1,1,0,0,0,0,10,463,153,66,85,86,73,"Leeds 099E","E01032497"
420,1382,756,727,618,135,483,26,7,19,83,24,59,29,12,9,9,6,3,0,0,0,0,0,0,3,614,398,64,55,63,34,"Leeds 099F","E01032498"
421,1461,1072,1027,905,180,725,16,3,13,106,40,66,45,34,28,25,20,5,3,3,0,0,0,0,6,355,172,47,52,53,31,"Leeds 099G","E01035048"
422,1179,924,897,799,154,645,16,4,12,82,21,61,27,14,8,8,5,3,0,0,0,0,0,0,6,241,126,25,28,31,31,"Leeds 099H","E01035049"
423,1213,890,866,768,150,618,20,2,18,78,27,51,24,28,21,21,16,5,0,0,0,0,0,0,7,295,171,39,28,41,16,"Leeds 100A","E01011496"
424,1647,1125,1096,963,197,766,23,2,21,110,45,65,29,21,14,11,11,0,0,0,0,3,2,1,7,501,355,31,49,41,25,"Leeds 100B","E01011630"
425,1282,725,686,586,152,434,23,3,20,77,33,44,39,24,18,18,12,6,0,0,0,0,0,0,6,533,357,44,53,52,27,"Leeds 100C","E01011634"
426,1550,911,887,762,171,591,31,5,26,94,39,55,24,24,20,20,19,1,0,0,0,0,0,0,4,615,477,40,38,33,27,"Leeds 100D","E01011636"
427,1196,673,633,561,137,424,12,1,11,60,27,33,40,20,12,12,9,3,0,0,0,0,0,0,8,503,294,48,44,76,41,"Leeds 100E","E01011639"
428,1066,624,557,510,172,338,10,2,8,37,13,24,67,29,18,16,14,2,0,0,0,2,2,0,11,413,134,62,81,84,52,"Leeds 101A","E01011491"
429,1252,703,650,592,158,434,6,0,6,52,21,31,53,19,11,10,10,0,0,0,0,1,1,0,8,530,173,72,102,131,52,"Leeds 101B","E01011492"
430,1194,698,641,567,165,402,10,2,8,64,24,40,57,40,28,27,17,10,0,0,0,1,1,0,12,456,126,70,94,103,63,"Leeds 101C","E01011493"
431,1203,735,686,588,156,432,17,3,14,81,30,51,49,29,21,18,14,4,1,1,0,2,2,0,8,439,148,96,102,41,52,"Leeds 101D","E01011494"
432,1221,708,634,580,188,392,6,1,5,48,15,33,74,25,17,17,11,6,0,0,0,0,0,0,8,488,168,74,108,97,41,"Leeds 101E","E01011497"
433,1558,980,936,833,190,643,21,6,15,82,34,48,44,25,20,18,18,0,2,1,1,0,0,0,5,553,258,58,86,101,50,"Leeds 102B","E01011540"
434,1720,1291,1247,1105,217,888,16,4,12,126,38,88,44,30,28,27,18,9,0,0,0,1,1,0,2,399,214,46,54,56,29,"Leeds 102F","E01032489"
435,1132,792,772,696,140,556,8,3,5,68,23,45,20,22,17,17,15,2,0,0,0,0,0,0,5,318,190,49,29,23,27,"Leeds 102G","E01032490"
436,975,681,658,582,134,448,12,0,12,64,28,36,23,19,10,10,8,2,0,0,0,0,0,0,9,275,206,28,18,13,10,"Leeds 102H","E01032491"
437,1755,1157,1094,984,218,766,14,4,10,96,36,60,63,39,30,30,22,8,0,0,0,0,0,0,9,559,232,50,75,121,81,"Leeds 102I","E01032492"
438,1315,743,704,606,152,454,14,4,10,84,31,53,39,22,14,14,10,4,0,0,0,0,0,0,8,550,358,44,52,65,31,"Leeds 103A","E01011307"
439,1210,728,706,623,163,460,14,4,10,69,26,43,22,22,18,18,12,6,0,0,0,0,0,0,4,460,344,38,32,23,23,"Leeds 103B","E01011308"
440,1754,1182,1150,1022,235,787,24,2,22,104,47,57,32,37,29,28,26,2,0,0,0,1,0,1,8,535,363,51,32,58,31,"Leeds 103C","E01011393"
441,971,557,532,447,140,307,11,2,9,74,22,52,25,18,16,16,16,0,0,0,0,0,0,0,2,396,277,38,26,40,15,"Leeds 103D","E01011394"
442,939,642,619,526,116,410,9,4,5,84,28,56,23,22,15,15,14,1,0,0,0,0,0,0,7,275,124,55,31,38,27,"Leeds 103E","E01011395"
443,1175,787,738,646,139,507,15,5,10,77,35,42,49,3,2,2,1,1,0,0,0,0,0,0,1,385,229,23,34,60,39,"Leeds 104A","E01011533"
444,1844,1040,1002,906,182,724,9,0,9,87,30,57,38,39,22,17,13,4,0,0,0,5,5,0,17,765,476,64,28,137,60,"Leeds 104B","E01011541"
445,1149,734,700,627,126,501,16,1,15,57,19,38,34,25,20,20,17,3,0,0,0,0,0,0,5,390,241,42,50,41,16,"Leeds 104C","E01011545"
446,1645,1066,1011,903,197,706,24,3,21,84,29,55,55,43,38,38,30,8,0,0,0,0,0,0,5,536,289,71,50,89,37,"Leeds 104D","E01011547"
447,1346,773,744,628,170,458,25,6,19,91,37,54,29,17,10,9,6,3,0,0,0,1,0,1,7,556,405,32,43,53,23,"Leeds 105D","E01011500"
448,1761,1236,1185,1049,229,820,22,3,19,114,31,83,51,30,23,23,18,5,0,0,0,0,0,0,7,495,314,60,34,54,33,"Leeds 105F","E01032496"
449,1170,891,851,765,179,586,17,3,14,69,30,39,40,22,14,14,9,5,0,0,0,0,0,0,8,257,103,51,53,28,22,"Leeds 105G","E01035050"
450,1237,971,944,825,144,681,27,4,23,92,36,56,27,33,31,30,25,5,0,0,0,1,1,0,2,233,105,60,28,22,18,"Leeds 105H","E01035051"
451,1120,789,756,662,121,541,15,1,14,79,30,49,33,18,13,13,10,3,0,0,0,0,0,0,5,313,115,49,43,60,46,"Leeds 105I","E01035052"
452,1263,972,956,828,172,656,16,0,16,112,43,69,16,37,30,28,18,10,0,0,0,2,0,2,7,254,120,50,37,34,13,"Leeds 105J","E01035053"
453,1161,708,685,600,138,462,17,4,13,68,23,45,23,20,15,14,10,4,0,0,0,1,0,1,5,433,312,29,38,33,21,"Leeds 106A","E01011530"
454,1822,1344,1312,1171,217,954,28,9,19,113,44,69,32,29,26,24,19,5,1,1,0,1,1,0,3,449,246,70,42,49,42,"Leeds 106B","E01011534"
455,1390,868,831,730,152,578,9,3,6,92,35,57,37,19,13,13,8,5,0,0,0,0,0,0,6,503,315,50,44,60,34,"Leeds 106C","E01011546"
456,1210,712,683,571,144,427,21,3,18,91,45,46,29,20,17,15,14,1,0,0,0,2,1,1,3,478,346,40,36,30,26,"Leeds 106D","E01011548"
457,1105,726,708,620,149,471,15,4,11,73,21,52,18,28,21,20,17,3,1,0,1,0,0,0,7,351,261,34,23,21,12,"Leeds 106E","E01011550"
458,1738,960,943,797,189,608,28,3,25,118,37,81,17,22,19,17,13,4,0,0,0,2,1,1,3,756,546,36,46,83,45,"Leeds 107A","E01011537"
459,1282,739,716,600,135,465,15,7,8,101,38,63,23,17,16,16,13,3,0,0,0,0,0,0,1,526,296,42,54,96,38,"Leeds 107B","E01011538"
460,1385,1016,992,864,183,681,10,1,9,118,38,80,24,25,16,15,11,4,0,0,0,1,1,0,9,344,179,60,36,39,30,"Leeds 107C","E01011551"
461,1167,655,614,529,133,396,6,3,3,79,32,47,41,36,31,29,22,7,1,1,0,1,1,0,5,476,210,46,83,101,36,"Leeds 107D","E01011552"
462,1417,815,808,663,160,503,35,11,24,110,49,61,7,20,12,12,12,0,0,0,0,0,0,0,8,582,415,61,40,36,30,"Leeds 108A","E01011535"
463,1382,837,822,669,155,514,28,4,24,125,48,77,15,28,20,20,17,3,0,0,0,0,0,0,8,517,355,51,49,38,24,"Leeds 108B","E01011536"
464,1158,828,803,684,172,512,26,7,19,93,42,51,25,22,18,18,18,0,0,0,0,0,0,0,4,308,223,42,28,10,5,"Leeds 108C","E01011549"
465,1151,734,713,605,145,460,17,7,10,91,37,54,21,16,11,11,11,0,0,0,0,0,0,0,5,401,295,30,32,30,14,"Leeds 108D","E01011553"
466,1898,1099,1065,912,178,734,32,7,25,121,68,53,34,92,58,52,39,13,0,0,0,6,6,0,34,707,277,349,34,20,27,"Leeds 109A","E01011685"
467,1234,730,706,585,149,436,24,6,18,97,44,53,24,19,12,12,12,0,0,0,0,0,0,0,7,485,308,69,51,28,29,"Leeds 109B","E01011687"
468,1193,664,641,531,93,438,20,4,16,90,52,38,23,81,56,51,40,11,0,0,0,5,3,2,25,448,293,106,14,16,19,"Leeds 109C","E01011690"
469,1313,860,838,698,121,577,16,5,11,124,63,61,22,30,19,18,12,6,0,0,0,1,0,1,11,423,239,89,28,29,38,"Leeds 109D","E01011692"
470,1357,1015,972,853,153,700,7,1,6,112,51,61,43,74,59,54,44,10,0,0,0,5,5,0,15,268,114,83,25,18,28,"Leeds 109E","E01011693"
471,1596,889,840,715,131,584,28,11,17,97,48,49,49,156,117,109,97,12,0,0,0,8,8,0,39,551,199,255,48,24,25,"Leeds 109F","E01011694"
472,1553,793,777,626,131,495,40,5,35,111,54,57,16,83,47,41,36,5,0,0,0,6,6,0,36,677,278,297,56,15,31,"Leeds 109G","E01032876"
473,1808,404,376,337,75,262,5,1,4,34,16,18,28,364,240,220,194,26,1,1,0,19,19,0,124,1040,33,942,14,33,18,"Leeds 110A","E01011442"
474,1794,568,546,479,74,405,9,1,8,58,30,28,22,308,228,204,182,22,3,3,0,21,16,5,80,918,44,774,18,45,37,"Leeds 110B","E01011443"
475,1930,308,268,244,61,183,1,0,1,23,12,11,40,400,267,229,204,25,3,1,2,35,33,2,133,1222,25,1105,25,27,40,"Leeds 110C","E01011444"
476,1452,529,516,431,79,352,10,3,7,75,42,33,13,183,113,97,77,20,2,2,0,14,12,2,70,740,128,540,12,35,25,"Leeds 110D","E01011451"
477,1593,433,396,350,93,257,4,0,4,42,28,14,37,355,250,228,202,26,3,3,0,19,16,3,105,805,45,669,22,42,27,"Leeds 110E","E01011668"
478,1354,504,469,418,106,312,5,2,3,46,23,23,35,253,145,133,108,25,0,0,0,12,11,1,108,597,33,485,19,25,35,"Leeds 110F","E01011669"
479,3047,686,660,576,109,467,13,5,8,71,36,35,26,511,331,292,229,63,2,2,0,37,33,4,180,1850,286,1454,20,21,69,"Leeds 110G","E01032946"
480,2136,461,433,391,29,362,7,2,5,35,9,26,28,342,194,175,148,27,0,0,0,19,17,2,148,1333,8,1260,8,7,50,"Leeds 111A","E01033008"
481,3477,515,488,435,61,374,21,2,19,32,15,17,27,568,297,259,224,35,4,4,0,34,32,2,271,2394,14,2323,11,16,30,"Leeds 111B","E01033010"
482,1315,874,842,762,53,709,13,1,12,67,34,33,32,114,83,66,47,19,1,1,0,16,16,0,31,327,18,259,16,9,25,"Leeds 111C","E01033011"
483,1469,1200,1153,1052,76,976,16,2,14,85,27,58,47,48,33,31,18,13,1,0,1,1,1,0,15,221,29,141,10,11,30,"Leeds 111D","E01033015"
484,999,791,759,673,67,606,13,4,9,73,23,50,32,38,29,27,13,14,0,0,0,2,1,1,9,170,23,101,12,16,18,"Leeds 111E","E01033016"
485,1605,965,907,824,152,672,19,4,15,64,27,37,58,33,30,30,17,13,0,0,0,0,0,0,3,607,313,54,83,100,57,"Leeds 112A","E01011467"
486,1578,951,902,809,221,588,19,3,16,74,17,57,49,36,29,27,16,11,1,1,0,1,0,1,7,591,217,81,94,138,61,"Leeds 112B","E01011468"
487,1047,620,592,514,154,360,11,4,7,67,28,39,28,14,13,13,9,4,0,0,0,0,0,0,1,413,216,41,49,62,45,"Leeds 112C","E01011470"
488,2497,1947,1897,1770,101,1669,17,2,15,110,31,79,50,108,67,56,39,17,2,1,1,9,9,0,41,442,18,344,29,4,47,"Leeds 112F","E01035054"


